NO maps/textures/base/withe_wall.xpm
SO maps/textures/base/grey_wall.xpm
WE maps/textures/base/red_wall.xpm
EA maps/textures/base/brown_wall.xpm

F 220,100,000
C 225,030,000

1111111
1000001
100S001
1000001
1111111