NO ../textures/north.xpm
SO ../textures/south.xpm
WE ../textures/west.xpm
EA ../textures/east.xpm

F 220,100,000
C 225,030,000

111111
100101
101001
1100N1
111111