NO maps/textures/base/withe_wall.xpm
SO maps/textures/base/grey_wall.xpm
WE maps/textures/base/red_wall.xpm
EA maps/textures/base/brown_wall.xpm

F 220,100,0
C 225,30,0

        1111111111111111111111111
        1000000000110000000000001
        1011000001110000000000001
        1001000000000000000000001
        1000000000000110000000001
111111111000000000000000000000001
100000000011111111000000000000001
10000000111      1000000000111111
100000001        1111100000111111
100000001            1000001
100000001            1000001
100000001           11000011
100000001          11000011
111100001111      11000011
111110000011      110000111111111
111111111011111111110000000000001
100000000011000001110111111111111
11110111111111011100000010001
11110111111111011101010010001
11000000110101011100000010001
10000000000000001100000010001
10000000000000001101010010001
11000001110101011111011110N0111
11110111 1110101 101111010001
11111111 1111111 111111111111